PPPPPPPPPPPPPPPPPPPPPPPPPPPPPPPPPPPPPPPPPPPPPPPPP
P                                               P
P                                  O            P
P                          O       P            P
P                          P      P  P        PPP
P   O                     P             P     T P
P C        A A            PO                  BXP
PPPPPPPPPPPPPPPPPPPPPPPPPPPPPPPPPPPPPPPPPPPPPPPPP
4