PPPPPPPPPPPPPPPPPPPPPPPPPPPPPPPPPPPPPPPPPPPPPPPPPPPPPPPPPPPP
P                                                          P
P                                                          P
P                                                          P
P          C    1                            3             P
P         PP   PP  PP  P  PP   PPP    PP   PPPPP  PPP      P
P        P    P  P P P P P   2 P  P  P  P    P    P        P
P        P    P  P P P P P  PP PPP   PPPP    P     P4   PPPP
P         PP   PP  P  PP  PP   P  P P    P   P    PPP   T  P
P                                                       B XP
PPPPPPPPPPPPPPPPPPPPPPPPPPPPPPPPPPPPPPPPPPPPPPPPPPPPPPPPPPPP