PPPPPPPPPPPPPPPPPPPPPPPPPPPPPPPPPPPPPPPPPPPPPPPPPPPPPPPPPPPPPPPPPPPPPPP
P                     VVVVVVVVVVVV P VVVV                VVVVV P      P
P                                  P                           P      P
P                                  P                           P      P  
P       PP    P  A A  P            P       1           P       P      P
P   A   VVP      PPP     P         P      APA   P              P    4 P
P  AP            PPP   P           P      PPP        P         P    P P
P  AP                 P     A      P                           P    V P
P  PV   AA  P      PPPP   PPP      P             P             PP     P
P  P AAAPPAAV             VVV  P   P      PPPPPP               P      P
P  PAPPP  PP      P               PP     P                     P   P  P
P  PP                   A          PP    V                        P   P
P  VV         PP    PPPPP        PPP      AAAAAAAAAAAAAAAAAAAPPP      P
P        PP                           PPPPPPPPPPPPPPPPPPPPPPPPPPP     P
P      A                     AAPP    PPP                       P     AP  
P    AAP  A     AA  A    A  PPPVVP C       PP                  P A   PP
P   2PP   P   PPPPPPPPPPPPPPPVV    P       P           P  P    P P    P
PP  P     V  P                     TPP     P   PPP       A     P  AP  P
P     PPP   P   PPPPPP         PPP BX PP   PP      A     P     PA P   P
P    P   PPP   P            P     PPPPP    P       PP    P     PP    PP
P   P         P            P       PPP     P  P    P    PP     P    A P  
PA  VP   PPPPP        P            PVV    AP      PP   A P     PP   P P
PPA  VP                            P     APP       P  PP P     P      P
PVPA     AAAAAAAAAAAAAAAAAAAAA   AAP     PPP    P  P    AP     P P    P
P VPAA  PPPPPPPPPPPPPPPPPPPPPP   PPP     VVP       PP   PP  A  P      P
P  VPP3   VVVVVVVVVVVVVVVVVVVV     P       P  P    P     P  P  P     PP
P   V P                       AA   P       P       P P   P  P  P P    P
P    VV                       PP  PPP      P     P P  A  P AP         P
P        P   P            P        P               P  PP   P         PP
P        V         A      V        P            P                   P P
P                PPP  P     P   P  P       P            PPPPP  PP     P
P                     P     P   P  P       P                   P      P 
PAAAAAAAAAAAAAAAAAAAAAPAAAAAPAAAPAAPAAAAAAAPAAAAAAAAAAAAAAAAAAAPAAAAAAP
PPPPPPPPPPPPPPPPPPPPPPPPPPPPPPPPPPPPPPPPPPPPPPPPPPPPPPPPPPPPPPPPPPPPPPP