PPPPPPPPPPPPPPPPPPPPPPPPPPPPPPPPPPP
P                                 P
P                                 P
P                                 P
P                                 P
PO   O   O              O    PPPPPP
P            P               T    P
PC            AAAA           B   XP
PPPPPPPPPPPPPPPPPPPPPPPPPPPPPPPPPPP

4