PPPPPPPPPPPPPPPPPPPPPPPPPPPPPPPPPPPP
P                                  P
P          OOO                   PPP
P          OOO                   T P
PC         OOO                   BXP
PPPPPPPPPPPPPPPPPPPPPPPPPPPPPPPPPPPP
9