PPPPPPPPPPPPPPPPPPPPPPPPPPPPPPPPPPP
P                                 P
P                                 P
P                                 P
P                                 P
PO   O   O              O    PPPPPP
P                            T    P
PC                           B   XP
PPPPPPPPPPPPPPPPPPPPPPPPPPPPPPPPPPP

4